25 25 25 25 25 25 25 25 25 25 25 25 25 25 25 25 25 25 25 25 25 25 25 25 25 25 25 25 25 25 25 25 25 25 25 25 25 25 25 25 25 25 25 25 25 25 25 25 25 25 
25 25 25 25 25 25 25 25 25 25 25 25 25 25 25 25 25 25 25 25 25 25 25 25 25 25 25 25 25 25 25 25 25 25 25 25 25 25 25 25 25 25 25 25 25 25 25 25 25 25 
25 25 25 25 25 25 25 25 25 25 25 25 25 25 25 25 25 25 25 25 25 25 25 25 25 25 25 25 25 25 25 25 25 25 25 25 25 25 25 25 25 25 25 25 25 25 25 25 25 25 
25 25 25 25 25 25 25 25 25 25 25 25 25 25 25 25 25 25 25 25 25 25 25 25 25 25 25 25 25 25 25 25 25 25 25 25 25 25 25 25 25 25 25 25 25 25 25 25 25 25 
25 25 25 25 25 25 25 25 25 25 25 25 25 25 25 25 25 25 25 25 25 25 25 25 25 25 25 25 25 25 25 25 25 25 25 25 25 25 25 25 25 25 25 25 25 25 25 25 25 25 
25 25 25 25 25 25 25 25 25 25 25 25 25 25 25 25 25 25 25 25 25 25 25 25 25 25 25 25 25 25 25 25 25 25 25 25 25 25 25 25 25 25 25 25 25 25 25 25 25 25 
25 25 25 25 25 25 25 25 25 25 25 25 25 25 25 25 25 25 25 25 25 25 25 25 25 38 25 25 25 25 25 25 25 25 25 25 25 25 25 25 25 25 25 25 25 25 25 25 25 25 
25 25 25 25 25 25 25 25 25 25 25 25 25 25 25 25 25 25 25 38 25 25 25 25 25 25 25 25 25 25 25 25 25 25 25 25 25 25 25 25 25 25 25 25 25 25 25 25 25 25 
25 25 25 25 25 25 25 25 25 25 25 25 25 25 25 25 25 25 25 25 25 25 25 25 25 25 25 25 25 25 25 25 25 25 25 25 25 25 25 25 25 25 25 25 25 25 25 25 25 25 
25 25 25 25 25 25 25 25 25 25 25 25 25 25 25 25 25 25 25 25 36 30 30 30 30 30 30 30 30 30 34 25 25 38 25 25 25 25 25 25 25 25 25 25 25 25 25 25 25 25 
25 25 25 25 25 25 25 25 25 25 25 25 25 25 25 36 30 30 30 30 33 10 10 10 23 10 24 10 10 10 28 34 25 25 25 25 25 25 25 25 25 25 25 25 25 25 25 25 25 25 
25 25 25 25 25 25 25 25 25 25 25 36 30 30 30 33 10 23 10 10 10 52 52 52 52 52 52 52 52 52 10 28 30 30 34 25 25 38 25 25 25 25 25 25 25 25 25 25 25 25 
25 25 25 25 25 25 25 25 38 25 25 32 10 52 10 52 52 52 52 52 52 52 52 52 52 52 52 52 52 52 52 52 10 10 27 25 25 25 25 25 25 25 25 25 25 25 25 25 25 25 
25 25 25 25 25 25 25 25 25 25 36 33 52 52 52 52 52 52 52 52 52 52 52 52 52 52 52 52 52 52 52 52 52 52 28 34 25 25 25 25 25 25 25 25 25 25 25 25 25 25 
25 25 25 25 25 25 25 25 25 36 33 10 52 52 52 52 52 52 52 52 52 52 10 10 10 10 10 10 10 52 52 52 52 52 10 28 30 34 25 25 25 25 25 25 25 25 25 25 25 25 
25 25 25 25 25 25 25 25 38 32 10 52 52 52 52 52 52 52 52 52 52 10 10 26 29 29 29 31 23 10 52 52 52 52 52 23 10 28 34 25 25 38 25 25 25 25 25 25 25 25 
25 25 25 25 25 25 25 25 25 32 52 52 52 52 52 52 52 52 52 52 10 10 26 35 25 25 25 37 31 10 10 52 52 52 52 52 52 10 27 25 25 25 25 25 25 25 25 25 25 25 
25 25 25 25 25 25 25 25 25 32 52 52 52 10 10 10 52 52 52 52 10 26 35 25 25 25 25 25 37 31 10 52 52 52 52 52 52 10 28 34 25 25 25 25 25 25 25 25 25 25 
25 25 25 25 25 25 25 25 36 33 52 52 10 23 10 10 10 52 52 52 23 27 25 25 38 25 25 25 25 32 10 52 52 52 52 52 52 52 10 27 25 25 25 25 25 25 25 25 25 25 
25 25 25 25 25 25 25 25 32 10 52 52 10 10 10 10 10 52 52 52 10 27 25 25 25 25 25 25 25 32 10 52 52 52 52 52 52 52 10 27 25 25 25 25 25 25 25 25 25 25 
25 25 25 25 25 25 25 25 32 10 52 52 52 10 10 23 52 52 52 52 10 28 34 25 25 25 38 25 36 33 10 52 52 24 10 10 52 52 10 27 25 25 25 25 25 25 25 25 25 25 
25 25 25 25 25 38 25 25 32 10 52 52 52 52 10 10 52 52 52 52 10 10 28 34 25 25 25 36 33 10 10 10 10 10 10 10 52 52 10 27 25 25 25 25 25 25 25 25 25 25 
25 25 25 25 25 25 25 25 32 10 52 52 52 52 52 10 52 52 52 52 52 10 10 28 30 30 30 33 10 10 52 52 52 10 10 24 52 52 10 27 38 25 25 25 25 25 25 25 25 25 
25 25 25 25 25 25 25 25 32 10 52 52 52 52 11 18 14 52 52 52 52 52 10 10 11 18 14 23 10 52 52 52 52 52 52 52 52 52 10 27 25 25 25 25 25 25 25 25 25 25 
25 25 25 25 25 25 25 25 32 10 52 52 52 52 12 54 15 52 52 52 52 52 52 52 12 54 15 52 52 52 52 52 52 52 52 52 52 52 24 27 25 25 25 25 25 25 25 25 25 25 
25 25 25 25 25 25 25 25 32 10 52 52 52 52 12 54 15 52 52 52 52 52 52 52 12 54 15 52 52 52 52 52 52 52 52 52 52 52 10 28 34 25 25 25 25 25 25 25 25 25 
25 25 25 25 25 25 38 25 32 10 10 52 52 52 12 54 22 18 18 18 18 18 18 18 21 54 15 52 52 53 53 53 53 53 53 53 53 53 10 10 27 25 25 25 25 25 25 25 25 25 
25 25 25 25 25 25 25 25 32 23 10 52 52 52 12 54 54 54 54 54 54 54 54 54 54 54 15 10 52 53 51 51 51 53 51 51 51 53 53 53 27 25 25 25 25 25 25 25 25 25 
25 25 25 25 25 25 25 25 32 10 10 10 52 52 13 17 17 17 17 17 17 17 17 17 20 54 15 10 52 53 51 51 51 51 51 51 51 51 51 53 27 25 25 38 25 25 25 25 25 25 
25 25 25 25 25 25 25 25 32 10 10 10 52 52 52 52 52 52 52 52 52 52 52 52 12 54 15 10 52 53 51 51 51 53 51 51 51 53 53 53 27 25 25 25 25 25 25 25 25 25 
25 25 25 25 25 25 25 25 32 10 10 10 52 52 52 52 52 52 52 52 52 52 52 52 12 54 15 10 52 53 53 51 53 53 53 53 53 53 52 10 27 25 25 25 25 25 25 25 25 25 
25 25 25 25 25 25 25 25 37 31 10 23 10 52 52 52 52 52 52 52 52 52 52 52 12 54 15 10 52 52 53 51 53 52 52 52 52 52 52 10 27 25 25 25 25 25 25 25 25 25 
25 25 25 25 25 25 25 25 25 32 10 10 10 10 52 52 52 52 52 52 52 52 52 52 12 54 15 10 10 52 53 51 53 52 52 52 52 52 10 26 35 25 25 25 25 25 25 25 25 25 
25 25 25 25 25 25 25 25 25 32 10 10 23 10 10 52 52 52 52 52 52 52 52 52 12 54 15 52 10 52 52 10 52 52 52 52 52 52 10 27 25 38 25 25 25 25 25 25 25 25 
25 25 25 25 25 25 25 25 25 37 31 10 10 10 10 10 11 18 18 18 14 52 52 52 12 54 15 52 10 24 52 10 52 52 52 52 52 52 26 35 25 25 25 25 25 25 25 25 25 25 
25 25 25 25 25 25 25 25 25 25 32 10 10 10 10 10 12 54 54 54 15 52 52 52 12 54 15 52 52 10 10 10 52 52 52 52 52 52 27 25 25 25 25 25 25 25 25 25 25 25 
25 25 25 25 25 25 25 25 38 25 32 10 10 10 10 10 13 17 20 54 22 18 18 18 21 54 15 52 52 52 10 52 52 52 52 52 52 10 27 25 25 25 25 25 25 25 25 25 25 25 
25 25 25 25 25 25 25 25 25 25 37 31 10 10 24 10 10 52 12 54 54 54 54 54 54 54 15 52 10 23 10 10 52 52 52 52 10 10 27 38 25 25 25 25 25 25 25 25 25 25 
25 25 25 25 25 25 25 25 25 25 25 37 31 10 10 10 10 52 13 17 17 17 17 17 20 54 15 23 10 52 52 52 52 52 52 52 10 10 27 25 25 25 25 25 25 25 25 25 25 25 
25 25 25 25 25 25 25 25 25 25 25 25 32 10 10 10 10 52 52 52 52 52 52 52 12 54 15 10 10 52 52 52 52 52 10 10 10 26 35 25 25 25 25 25 25 25 25 25 25 25 
25 25 25 25 25 25 25 25 25 25 25 25 37 29 31 23 10 10 52 52 52 52 52 52 13 17 16 10 52 52 52 52 52 52 10 10 26 35 25 25 25 38 25 25 25 25 25 25 25 25 
25 25 25 25 25 25 25 25 25 25 25 25 25 25 32 10 10 10 10 52 52 52 52 52 10 10 10 52 52 52 52 52 10 10 10 26 35 25 25 25 25 25 25 25 25 25 25 25 25 25 
25 25 25 25 25 25 25 25 25 25 25 25 25 25 37 31 10 24 10 10 52 52 52 52 10 10 52 52 10 10 10 10 10 10 26 35 25 25 25 25 25 25 25 25 25 25 25 25 25 25 
25 25 25 25 25 25 25 38 25 25 25 25 25 25 25 32 10 10 10 10 10 10 10 10 10 10 10 10 10 26 29 29 29 29 35 25 25 25 25 25 25 25 25 25 25 25 25 25 25 25 
25 25 25 25 25 25 25 25 25 25 25 25 25 25 25 37 29 29 29 29 29 29 29 29 29 29 29 29 29 35 25 25 25 25 25 25 25 25 25 25 25 25 25 25 25 25 25 25 25 25 
25 25 25 25 25 25 25 25 25 25 25 25 25 25 25 25 25 25 25 25 25 25 25 25 25 25 25 25 25 25 25 25 25 38 25 25 25 25 25 25 25 25 25 25 25 25 25 25 25 25 
25 25 25 25 25 25 25 25 25 25 25 25 25 25 38 25 25 25 25 25 25 25 25 25 25 25 25 25 25 25 25 25 25 25 25 25 25 25 25 38 25 25 25 25 25 25 25 25 25 25 
25 25 25 25 25 25 25 25 25 25 25 25 25 25 25 25 25 25 25 25 25 25 25 38 25 25 25 25 25 25 25 25 25 25 25 25 25 25 25 25 25 25 25 25 25 25 25 25 25 25 
25 25 25 25 25 25 25 25 25 25 25 25 25 25 25 25 25 25 25 25 25 25 25 25 25 25 25 25 25 25 25 25 25 25 25 25 25 25 25 25 25 25 25 25 25 25 25 25 25 25 
25 25 25 25 25 25 25 25 25 25 25 25 25 25 25 25 25 25 25 25 25 25 25 25 25 25 25 25 25 25 25 25 25 25 25 25 25 25 25 25 25 25 25 25 25 25 25 25 25 25 